uname - ინსტალირებული ოპერაციული სისტემის შესახებ ინფორმაცია
uptime - სისტემის დატვირთულობა
hostname - ჰოსტის სახელი ქსელში
reboot -სისტემის გადატვირთვა
date - სისტემური თარიღი
cal - მიმდინარე კალენდარული თვე
w - ვინ არის სისტემაში შესული
who - ვინ არის სისტემაში შესული
whoami - ვინ არის სისტემაში შესული
id - ვინ არის სისტემაში შესული
last - ვინ იყო სისტემაში შესული
lscpu - cpu-ს აღწერილობა
lshw - ხელმისაწვდომი სკანირებული ჰარდვეარი
fdisk - დისკის დანაწილება - პარტიშენინგი
lsblk - დისკის დანაწილების შედეგი
df - დისკზე ფრაგმენტების მოცულობები
du - დისკზე დაკავებული ზომა
free - ოპერატიული მეხსიერებაზე ინფო
ls - დირქეტორისი შიგთავსის გამოტანა
pwd - სად იმყოფები ახლა
touch - ფაილების შექმნა
cp - კოპირება
mv - გადატანა
mkdir - დირექტორიის შექმნა
rm - ფაილის წაშლა 
chown - მფლობელის შეცვლა
chmod - წვდომის ატრიბუტების შეცვლა
wc - ფაილის სტრუქტურაზე ინფო, რამდენი სტრიქონი, სიტყვა და სხვა
tr - ამოკითხული ტექსის ტრანსფორმაცია
uniq - უნიკალურის დამტოვებელი
sort - ასორტირებს
split - ყოფს დიდ ფაილს სასურველ ზომებად
head - ფაილის საწყისი 10 ხაზის გამომტანი
tail - ფაილის ბოლო 10 ხაზის გამომტანი
more - ფაილის წამკითხავი
less - ფაილის წამკითხავი
cat - ფაილის წამკითხავი
strings - ბაინერ ფაილის წამკითხავი
ifconfif - ქსელური ინტერფესუების ჩამონათვალი
ip - ქსელური პარამეტრების გაწერა
nslookup - კონკრეტული დომეინის უკან მყოფი აიპის გამომტანი
top - პროცესების დინამიური მაკონტროლებელი
htop - პროცესების დინამიური მაკონტროლებელი ორონდ ბევრად მოსახერხებელი 
ps - პროცესების სტატიკური მდგომარეობა
kill - პროცესის მოკვლა
nice - პროცესის დასტარტვა კოკრეტული პრიორიტეტით
renice - პროცესის პრიორიტეტის შეცვლა
alias - საკუტარი ქომანდის შექმნა
at - ერთჯერადი ავტომატიზაცია
crontab - მრავალჯეადი ავტომატიზაცია
bc - საბაზისო კალკულატორი
gzip - შეკუმშვა
bzip2 - შეკუმშვა
xz - შეკუმშვა
p7zip - შეკუმშვა
cd - ნავიგაცია დირექტორიებში
cmp - ფაილებს შორის განსხავების აყმომჩენი
comm - ფაილებს შორის განსხავების აყმომჩენი
diff - ფაილებს შორის განსხავების აყმომჩენი
cut - სასურველი სვეტის ან რაოდონეობა სიმბოლოს ამორება
echo - ტერმინალში დამპრინტავი
env - გლობალური ანუ გარემოს პარამეტრები
exit - სესიიდან გასვლა
file - ფაილის ტიპობრიობა
shuf - არევა
find - ძებნა
locate - ძებნა
fmt - გამოტანის ფორმატირება სასურველი სიგანე და სხვა
grep - რეგულარული გამოსახულების მხარდამჭერი
sed - რეგულარული გამოსახულების მხარდამჭერი
jobs - ფონური პროცესების მაკონტროლებელი
nl - გადანომვრა
ln - სოფტლინკები, მალსახმობი ანუ შორტქათი
passwd - პაროლის შეცვლა
screen - მულტიპლექსერი
tmux - მულტიპლექსერი
seq - რიცხვითი მიმდევრობის შექმნა
tar - დაარქვივება
type - ქომანდის ტიპის გარკვევა
useradd - მომხმარებლის დამატება
usermod - მომხმარელის მოდიფიცირება
userdel - მომხმარებლის წაშლა
cmatrix - სკრინსეივერი
fortune - ტესტების ბაზიდან შემტხვევითი ტექსტის გამოტანა
figlet - ტექსტის გაფორმება 
toilet - ტექსტის გაფორმება (--gay და --metal ოფციები)
cowsay - ტექსტის გაფორმება, ძროამ თქვას პრინციპით 
sl - სცრინსეივერი ერთჯერადი მატარებელი (-F,-l,-a,-e ოფციები)
lolcat - რანდომულად შემაფერადებელი (-a დაყოვნებით შეფერადება)
asciiquarium - სკრინსეივერი აკვარიუმი
rig - შემთხვევითი მისამართი

მარტივი და სახალისო ქომანდები: cmatrix, fortune, figlet, toilet, cowsay, sl, lolcat, asciiquarium, rig წესით არ ქინება გარემოში და საინსტალაციო იქნება.
ინსტალაცია - sudi apt install პაკეტის სახელი 
